111111111111111111111111111
142222222222212222222222221
121111211111212111112111121
121111211111212111112111121
122222222222222222222222221
121111211211111112112111121
122222211222212222112222221
111111211111010111112111111
111111211000000000112111111
111111211011131110112111111
111111211010000010112111111
000000200010050010002000000
111111211010000010112111111
111111211011111110112111111
111111211000000000112111111
111111211011111110112111111
122222222222212222222222221
121111211111212111112111121
121111211111212111112111121
122211222222202222222112221
111211211211111112112112111
122222211222212222112222221
121111111111212111111111121
121111111111212111111111121
122222222222222222222222261
111111111111111111111111111